CCCCCCCCCC
CS**SS**SC
CCCCCCCCCC
C*CC**CC*C
CCCCCCCCCC
CS**SS**SC
CCCCCCCCCC
C*CC**CC*C
CCCCCCCCCC
CS**SS**SC
CCCCCCCCCC