UCCCCCCCCU
U********U
CCCCCCCCCC
CSSSSSSSSC
CCCUUUUCCC
CCCCUUCCCC
CCCCCCCCCC
S********S
CSCCCCCCSC
UCCCCCCCCU